 ### ####### ######### ########### ### #
#   #       #         #           #   # #
# # ### # ### ### ### ### # ##### # # # #
# #   # #       # #     # # #     # # # #
# ### ######### # ##### ### # ##### # # #
# #*# #     #   #   #       # #   # # # #
# # # # ### ####### ######### # # # # # #
# #     # #   #   #   #     #   #   # # #
# ####### ### # # ### # # ###### #### # #
#       #   #   # #   # #       #   #   #
# ##### # ####### # ## #### ##### # ### #
# #   # #         #   #   #       #   # #
# ### # ### ######### # # ### ##### # # #
#     #   # #   #     # #   #     # # # #
 #### ### # # # ### # # ### ####### # # #
#     #   #   #     # # # #   #     # # #
# ##### ## #### #### ## # ### # ####### #
# #   #   #     #   #   # #   # #       #
# ### ### ### ### # # ### # ### # ######
#       #   # #   #   #   #   # #     # #
# ###### ## # # ####### ##### # ##### # #
# #     #   # #      @# #     # #     # #
 ## ### # ### ######### # ##### # ##### #
#   #   # # #   #   #   #     # # #   # #
# ### ### # # ### # # # ##### # # # # # #
# #       #   #   #   #     # # #   # # #
# ######### ### ###### #### # # ##### # #
# #     #   # # #     #   #   #     # # #
# # ### # ### # # # ### # ##### ### # # #
# # # # # #   # # # #   #     # #   #   #
# # # # # ### # ### # ##### # # # ##### #
# #   # #   # #   #       # # # # #     #
# # ### ### # ### ####### # # ### # ####
# # #   #       #   #     # # #   # #   #
# # # ##### #### ## # ##### # # # # # # #
#   # #   # #   #   # # #   #   # # # # #
 #### # # ### # # ### # # ## #### # ### #
#   #   #     #   # #   #   #   # #   # #
# # ############### ### ### # # ##### # #
# #                       #   #         #
 # ####################### ### #########
