 ### ####### ######### ########### ### # 
#   #       #         #           #   # #
# # ### # ### ### ### ### # ##### # # # #
# #   # #       # #     # # #     # # # #
# ### ######### # ##### ### # ##### # # #
# #*# #     #   #   #       # #   # # # #
# # # # ### ####### ######### # # # # # #
# #     # #   #   #   #     #   #   # # #
# ####### ### # # ### # # ###### #### # #
#       #   #   # #   # #       #   #   #
# ##### # ####### # ## #### ##### # ### #
# #   # #         #   #   #       #   # #
# ### # ### ######### # # ### ##### # # #
#     #   # #   #     # #   #     # # # #
 #### ### # # # ### # # ### ####### # # #
#     #   #   #     # # # #   #     # # #
# ##### ## #### #### ## # ### # ####### #
# #   #   #     #   #   # #   # #       #
# ### ### ### ### # # ### # ### # ###### 
#       #   # #   #   #   #   # #     # #
# ###### ## # # ####### ##### # ##### # #
# #     #   # #      @# #     # #     # #
 ## ### # ### ######### # ##### # ##### #
#   #   # # #   #   #   #     # # #   # #
# ### ### #   ### # # # ##### # # # # # #
# #       #   #   #   #     # # #   # # #
# ########    # ###### #### # # ##### # #
# #     #     # #     #   #   #     # # #
# # ### #     # # # ### # ##### ### # # #
# # # # #     # # # #   #     # #   #   #
# # # # #     # ### # ##### # # # ##### #
# #   # #     #   #       # # # # #     #
# # ### #      ## ####### # # ### # #### 
# # #   #       #   #     # # #   # #   #
# # # ####   ### ## # ##### # # # # # # #
#   # #   # #   #   # # #   #   # # # # #
 #### # # ### # # ### # # ## #### # ### #
#   #   #     #   # #   #   #   # #   # #
# # ############### ### ### # # ##### # #
# #                       #   #         #
 # ####################### ### ######### 

